NO ./maps/textures/north.xpm
SO ./maps/textures/south.xpm
EA ./maps/textures/east.xpm
WE ./maps/textures/west.xpm
C 250,255,255
F 100,100,100

11111111
100000001 
1E0000001
100000001 
100000001 
100000001 
11111111
