NO ./maps/textures/north.xpm
SO ./maps/textures/south.xpm
EA ./maps/textures/east.xpm
WE ./maps/textures/west.xpm
C 100,250,100
F 150,100,225

11111111
10000000111111111111111111111111111111111111111111 
10000000111111111111111111111111111111111111111111
100S000011111111111111111111111111111111111111111111 
1000000000000000000000000000000000000000000000000001 
100000001 
11111111
