NO ./maps/textures/path_to_north_texture
SO ./maps/textures/path_to_south_texture
EA ./maps/textures/path_to_east_texture
WE ./maps/textures/path_to_west_texture
C 250,255,255
F 100,100,100

        1111111111111111111111111
        1000000000110000000000001
        1011000001110000000000001
        1001000000000000000000001
111111111011000001110000000000001
100000000011000S01110111111111111
11110111111111011100000010001
11110111111111010101010010001
11000000110101011100000010001
10000000000000001100000010001
10000000000000001101010010001
11000001110101011111011110N0111
11110111 1110101X101111010001
11111111 111111 111111111111